NO textures/Wall_wood.xpm
SO textures/Wall_wood.xpm
WE textures/Wall_Castle.xpm
EA textures/Wall_Castle.xpm
DD textures/Door.xpm

F 50,50,50
C 150,150,255


111111111111
100000000001
100000000001
 1000N00001
  10000001
   100001
    1001
     11






                       









                    