NO textures/Wall_wood.xpm
SO textures/Wall_wood.xpm
WE textures/Wall_Castle.xpm
EA textures/Wall_Castle.xpm
DD textures/Door.xpm
F 164,169,20
C 153,204,255


111111
111111
1N0001
100001
111111
