1111111111
1P00000001
1000000C01
1000000001
1000000001
1111101111
1000000001
11111111E1
