NO textures/wet_sponge.xpm
SO textures/wet_sponge.xpm
WE textures/wet_sponge.xpm
EA textures/wet_sponge.xpm


F 255,255,255
C 0,0,0
        
       
        
       
        
       
111111111111
100N00000001
111111111111