NO    textures/wet_sponge.xpm

SO textures/wet_sponge.xpm

WE    textures/wet_sponge.xpm

EA textures/wet_sponge.xpm

F    255,255,0



C   0,42,55

 1 1 1 1
11111111111
10N000000011
11111111111
1  1   1  11
