111111111111111111111111111111
1E0000000000000C00000C01000001
101010100100000101001010010101
101010010101010001000000010101
1P000000C00C000000001C1000C001
111111111111111110000000001111
110000000000000C00000C01000001
101010100100000101001010010101
101010010101010001000000010101
10000000C00C000000001C1000C001
111111111111111111111111111111